Amsterdam	LOC
BÃ¼rostuhl	ORG
Der Tote	MISC
Fake news	LOC
Geldern	LOC
Greed-Elsegier-Konzerns	LOC
Manu Friederich	PER
Matthias Egger	PER
Open-Access-Bewegung	MISC
Reed Elsevier	PER
Sonarweg 31	LOC
Steuergeld â€“	MISC
TatortÂ	MISC
UniversitÃ¤ten	MISC
russischer	MISC
rÃ¼cksichtslos	MISC
skandalÃ¶sen Monopolmissbrauch	MISC
wÃ¤re	MISC
zurÃ¼ckkaufen	LOC
Â	MISC
Ã–ffentlichkeit	MISC
â€“	MISC
