Auftr√§ge	MISC
Berlin	LOC
Bern	LOC
Botulinumneurotoxin	PER
Bundesamt f√ºr R√ºstung	ORG
Corina Liebi	PER
David Gugerli	PER
Deutschland	LOC
Disziplinen	MISC
Dual	LOC
Dual-Use	LOC
Dual-Use-Potenzial	MISC
EPFL	ORG
ETH	ORG
ETHs	MISC
Einzelf√§llen	LOC
Fakult√§ten	MISC
Finger	LOC
Forschungspartnerschaften	MISC
Forschungsprojekten	ORG
Forschungsziele	ORG
Frankreich	LOC
GSoA	MISC/ORG
Grenzen	LOC
Gr√ºnde daf√ºr	MISC
Gugerli	PER
G√ºterabw√§gung	MISC
Hochschule und Milit√§r	ORG
Im letzten Jahr	MISC
Instituts f√ºr Infektionskrankheiten	ORG
Janine B√§chle	PER
Japan	LOC
Kaiserslautern	LOC
Kollaboration	LOC
Kontrollratsgesetz Nr.	LOC
Kryptografie	LOC
Liebi	PER
Life Sciences	ORG
Manhattan Project	ORG
Max Br√ºck	PER
Milit√§r	ORG
Milit√§rs	MISC
Neuenburg	LOC
Pentagon	LOC
Pr√§vention	MISC
Richtlinien	LOC
Roland Fischer	PER
R√ºstungsforschung durchgef√ºhrt	MISC
Schweiz	LOC
Schweiz w√§re	MISC
Schweizer	MISC
Seco ‚Ä	PER
Staatssekretariat f√ºr Wirtschaft	ORG
TU Berlin	ORG
TU-Forschungsabteilung	ORG
Technische	LOC
Teleskop-Kontaktlinse	MISC
Thomas Leibundgut	PER
Tierversuchen	MISC
US Air Force	ORG
UZH	ORG
Uni	ORG
Uni Basel	ORG
University of Oxford	ORG
Universit√§ten	MISC
Universit√§ten Bern	ORG
Universit√§tsleitung	MISC
Use Joker	PER
Waffen-Forschungsprojekte	MISC
Workshop	LOC
Zivilklausel	LOC
Zweiten Weltkrieg	MISC
amerikanische	MISC
den USA	LOC
der Schweiz	LOC
eingef√ºhrt	MISC
forschungspolitischen	MISC
franz√∂sischen Ingenieurs-tradition	ORG
fr√ºher	MISC
f√ºr	ORG
f√ºr r√ºstungsrelevante	MISC
gegen√ºber	MISC
industriellen Revolution	MISC
k√∂nne	MISC
k√∂nnen	MISC
milit√§risch-p√§dagogischen	MISC
prim√§r Grundlagenforschung	ORG
schweizerisches	MISC
w√§re	MISC
zug√§nglich	MISC
|	MISC
√ºberrascht	MISC
‚Ä	PER
‚Äì	MISC
ì	MISC
ì pr√§ziser	MISC
