140 million	CARDINAL
1942	DATE
1946	DATE
1991	DATE
2.7 million	CARDINAL
2014	DATE
2015	DATE
25	CARDINAL
3.4 million	CARDINAL
American	NORP
Armasuisse	ORG/PERSON
Bern	NORP/ORG
B체hrle	PERSON
Corina Liebi	PERSON
Darpa Program'	ORG
David Gugerli	PERSON
EMPA	PRODUCT
EPFL	ORG
ETH Zurich	GPE/ORG/PERSON/WORK_OF_ART
European	NORP
France	GPE
French	NORP
GSOA	ORG
Germany	GPE
Gugerli	GPE/PERSON
Janine B채chle	PERSON
Japan	GPE
Last year	DATE
Liebi	ORG
Max Br체ck	PERSON
Neuch창tel	ORG
One	CARDINAL
Pentagon	ORG
Roland Fischer	PERSON
Ruag	PERSON
SECO	ORG
Sonntagszeitung	ORG
Swiss	NORP
Switzerland	GPE
TU Berlin	PERSON
The Federal Office for Defence Procurement	ORG
The Manhattan Project	ORG
The TU Berlin	PERSON
The University of Basel	ORG
The University of Zurich	ORG
Thomas Leibundgut	PERSON
Three years ago	DATE
University	ORG
Zurich	GPE
between 2011 and 2013	DATE
more than a million dollars	MONEY
only one	CARDINAL
roughly a dozen	CARDINAL
some 150,000	CARDINAL
the 'Group for a	ORG
the Allied Control Council Act No	ORG
the Department of Biology	ORG
the Industrial Revolution	EVENT
the Institute for Infectious Diseases	ORG
the Offenbach University of Art and Design	ORG
the Second World War	EVENT
the Spiez Laboratory	ORG
the State Secretariat for Economic Affairs	ORG
the Swiss Federal Office for Civil Protection	ORG
the TU Berlin Research Department	ORG
the Technical University of Berlin	ORG
the US Air Force	ORG
the Universities of Bern	ORG
the Universities of Zurich, Bern	ORG
the University of Bern	ORG
the University of Bern"	ORG
the University of Oxford and the Technical University of Kaiserslautern	ORG
third	ORDINAL
this day	DATE
today	DATE
two	CARDINAL
