Title: Who’s Who	MISC
Pascale Hofmeier	PER
Direction du développement et de la coopération	ORG
DDC	ORG
Le	LOC
Suisse	LOC
DDC	ORG
Programme r4d	MISC
DDC	ORG
FNS	ORG
Afrique	LOC
Asie	LOC
Amérique latine	ORG
Swiss Programme for Research on Global Issues for Development	ORG
Nord-Sud	MISC
Les	LOC
Swiss TPH	MISC
Institut tropical et de santé publique à Bâle	ORG
Swiss TPH	ORG
Près	MISC
Universités	LOC
Suisse	LOC
Institut de hautes études internationales et du développement	ORG
IHEID	ORG
Genève	ORG
Nations Unies	ORG
Université de Berne	LOC
Centre for Development and Environment	ORG
International Graduate School North- South	ORG
IGS	ORG
Pôle de recherche national Nord-Sud	MISC
Asie	LOC
Afrique	LOC
Amérique	LOC
Europe	LOC
IGS	ORG
EPF	ORG
Les	LOC
Centre coopération & développement	ORG
CODEV	LOC
EPFL	ORG
Chaire UNESCO	ORG
Sud	LOC
ETH Zurich	LOC
Mobile Health Systems Laboratory	ORG
NADEL	ORG
Centre	LOC
KFPE	MISC
Commission pour le partenariat scientifique avec les pays en développement	MISC
KFPE	ORG
Son	LOC
DDC	ORG
FNS	ORG
Académie suisse des sciences naturelles	ORG
Réseaux	MISC
Swiss Forum for International Agricultural Research	ORG
SFIAR	ORG
Swiss Network for International Studies	ORG
SNIS	ORG
Swissuniversities Development and Cooperation Network	ORG
SUDAC	ORG
Sud	LOC
